Africa/Cote d'Ivoire/*/*	Africa/Côte d'Ivoire/*/*
Africa/Cote d'Ivoire/Tai National Park/*	Africa/Côte d'Ivoire/Bas-Sassandra/Tai National Park
Africa/Democratic Republic of the Congo/Province Bandundu/*	Africa/Democratic Republic of the Congo/Bandundu/*
Africa/Democratic Republic of the Congo/Province Equateur/*	Africa/Democratic Republic of the Congo/Équateur/*
Africa/Democratic Republic of the Congo/Province Kasai Occidental/*	Africa/Democratic Republic of the Congo/Kasaï-Occidental/*
Africa/Democratic Republic of the Congo/Province Kasai Oriental/*	Africa/Democratic Republic of the Congo/Kasaï-Oriental/*
Africa/Democratic Republic of the Congo/Province P. Oriental/*	Africa/Democratic Republic of the Congo/Orientale/*
Africa/Democratic Republic of the Congo/Yangdongi/	Africa/Democratic Republic of the Congo/Mongala/Yangdongi
Africa/Democratic Republic of the Congo/Zaire/*	Africa/Democratic Republic of the Congo//
Africa/Zaire/*/*	Africa/Democratic Republic of the Congo//
*/Zaire/*/*	Africa/Democratic Republic of the Congo//
Europe/France/Paris/*	Europe/France/Ile de France/Paris FR
Europe/Italy/Fvg/Gorizia	Europe/Italy/Friuli Venezia Giulia/Gorizia
# Unclear which location is the real location
Europe/Netherlands/Utrecht/Rotterdam	Europe/Netherlands//
North America/USA/Washington/Dc        North America/USA/Washington DC/
North America/USA/Albany Co./Ny	North America/USA/New York/Albany Co.
North America/USA/Albuquerque Nm/	North America/USA/New Mexico/Albuquerque Nm
North America/USA/Amarillo Tx/	North America/USA/Texas/Amarillo Tx
North America/USA/Bethlehem Pa/	North America/USA/Pennsylvania/Bethlehem Pa
North America/USA/Bismark Nd/	North America/USA/North Dakota/Bismark Nd
North America/USA/Brandford/Ct	North America/USA/Connecticut/Brandford
North America/USA/Bronx Co./Ny	North America/USA/New York/Bronx Co.
North America/USA/Broome Co./Ny	North America/USA/New York/Broome Co.
North America/USA/Cattaraugus Co./Ny	North America/USA/New York/Cattaraugus Co.
North America/USA/Cayuga Co./Ny	North America/USA/New York/Cayuga Co.
North America/USA/Chautauqua Co./Ny	North America/USA/New York/Chautauqua Co.
North America/USA/Chemung Co./Ny	North America/USA/New York/Chemung Co.
North America/USA/Cheyenne Wy/	North America/USA/Wyoming/Cheyenne Wy
North America/USA/Clinton Co./Ny	North America/USA/New York/Clinton Co.
North America/USA/Collin Co. Tx/	North America/USA/Texas/Collin Co. Tx
North America/USA/Columbia Co./Ny	North America/USA/New York/Columbia Co.
North America/USA/Conneticut/*	North America/USA/Connecticut/*
North America/USA/Cortland Co./Ny	North America/USA/New York/Cortland Co.
North America/USA/Dallas Co. Tx/	North America/USA/Texas/Dallas Co. Tx
North America/USA/Dallas Tx/	North America/USA/Texas/Dallas Tx
North America/USA/Davenport Ia/	North America/USA/Iowa/Davenport Ia
North America/USA/Denton Co. Tx/	North America/USA/Texas/Denton Co. Tx
North America/USA/Denton/Denton Co., Texas	North America/USA/Texas/Denton
North America/USA/Dutchess Co./Ny	North America/USA/New York/Dutchess Co.
North America/USA/El Paso Co. Tx/	North America/USA/Texas/El Paso Co. Tx
North America/USA/El Paso Tx/	North America/USA/Texas/El Paso Tx
North America/USA/Ellis Co. Tx/	North America/USA/Texas/Ellis Co. Tx
North America/USA/Elyria Oh/	North America/USA/Ohio/Elyria Oh
North America/USA/Erie Co./Ny	North America/USA/New York/Erie Co.
North America/USA/Erie County/Ny	North America/USA/New York/Erie County
North America/USA/Essex Co./Ny	North America/USA/New York/Essex Co.
North America/USA/Fairview/Collin Co., Texas	North America/USA/Texas/Fairview
North America/USA/Fort Bend Co. Tx/	North America/USA/Texas/Fort Bend Co. Tx
North America/USA/Fort Collins/Co	North America/USA/Texas/Fort Collins
North America/USA/Fulton Co./Ny	North America/USA/Texas/Fulton Co.
North America/USA/Gainsville Fl/	North America/USA/Florida/Gainsville Fl
North America/USA/Galveston County/Tx	North America/USA/Texas/Galveston County
North America/USA/Genesee Co./Ny	North America/USA/New York/Genesee Co.
North America/USA/Gilbert/Maricopa Co., Az	North America/USA/Arizona/Gilbert
North America/USA/Glendale/Maricopa Co., Az	North America/USA/Arizona/Glendale
North America/USA/Glenview Il/	North America/USA/Illinois/Glenview Il
North America/USA/Goose Creek Sc/	North America/USA/South Carolina/Goose Creek Sc
North America/USA/Grand Junction Co/	North America/USA/Colorado/Grand Junction Co
North America/USA/Greene Co./Ny	North America/USA/New York/Greene Co.
North America/USA/Harris County/Tx	North America/USA/Texas/Harris County
North America/USA/Herkimer Co./Ny	North America/USA/New York/Herkimer Co.
North America/USA/Houston Tx/	North America/USA/Texas/Houston Tx
North America/USA/Houston/Harris Co., Texas	North America/USA/Texas/Houston
North America/USA/Houston/Harris Co., Tx	North America/USA/Texas/Houston
North America/USA/Indianapolis In/	North America/USA/Indiana/Indianapolis In
North America/USA/Jackson Tn/	North America/USA/Tennessee/Jackson Tn
North America/USA/Jefferson Co./Ny	North America/USA/New York/Jefferson Co.
North America/USA/Kansas City Mo/	North America/USA/Missouri/Kansas City Mo
North America/USA/Kathy/Harris Co., Tx	North America/USA/Texas/Kathy
North America/USA/Katy/Harris Co., Texas	North America/USA/Texas/Katy
North America/USA/Kings Co./Ny	North America/USA/New York/Kings Co.
North America/USA/La Habra Ca/	North America/USA/California/La Habra Ca
North America/USA/Las Vegas Nv/	North America/USA/Nevada/Las Vegas Nv
North America/USA/Lewis Co./Ny	North America/USA/New York/Lewis Co.
North America/USA/Lexington/Ma	North America/USA/Massachusetts/Lexington
North America/USA/Lincoln Ne/	North America/USA/Nebraska/Lincoln Ne
North America/USA/Little Rock Ak/	North America/USA/Arkansas/Little Rock Ak
North America/USA/Livingston Co./Ny	North America/USA/New York/Livingston Co.
North America/USA/Los Angeles Ca/	North America/USA/California/Los Angeles Ca
North America/USA/Lubbock Tx/	North America/USA/Texas/Lubbock Tx
North America/USA/Madison Co./Ny	North America/USA/New York/Madison Co.
North America/USA/Memphis Tn/	North America/USA/Tennessee/Memphis Tn
North America/USA/Miami Fl/	North America/USA/Florida/Miami Fl
North America/USA/Miami Florida/	North America/USA/Florida/Miami Florida
North America/USA/Milwalkee Wi/	North America/USA/Wisconsin/Milwalkee Wi
North America/USA/Minneapolis Mn/	North America/USA/Minnesota/Minneapolis Mn
North America/USA/Monroe Co./Ny	North America/USA/New York/Monroe Co.
North America/USA/Montgomery Co. Tx/	North America/USA/Texas/Montgomery Co. Tx
North America/USA/Montgomery Co./Ny	North America/USA/New York/Montgomery Co.
North America/USA/Montgomery County/Tx	North America/USA/Texas/Montgomery County
North America/USA/Nassau Co./Ny	North America/USA/New York/Nassau Co.
North America/USA/Nassau County/Ny	North America/USA/New York/Nassau County
North America/USA/New Orleans la/	North America/USA/Louisiana/New Orleans la
North America/USA/New York City/	North America/USA/New York/New York City
North America/USA/New York Co./Ny	North America/USA/New York/New York Co.
North America/USA/New York Ny/	North America/USA/New York/New York Ny
North America/USA/Niagara Co./Ny	North America/USA/New York/Niagara Co.
North America/USA/Oklahoma City Ok/	North America/USA/Oklahoma/Oklahoma City Ok
North America/USA/Oneida Co./Ny	North America/USA/New York/Oneida Co.
North America/USA/Onondaga Co./Ny	North America/USA/New York/Onondaga Co.
North America/USA/Ontario Ca/	North America/USA/California/Ontario Ca
North America/USA/Ontario Co./Ny	North America/USA/New York/Ontario Co.
North America/USA/Orange Co./Ny	North America/USA/New York/Orange Co.
North America/USA/Orlando Fl/	North America/USA/Florida/Orlando Fl
North America/USA/Orleans Co./Ny	North America/USA/New York/Orleans Co.
North America/USA/Oswego Co./Ny	North America/USA/New York/Oswego Co.
North America/USA/Otsego Co./Ny	North America/USA/New York/Otsego Co.
North America/USA/Pasadena/Harris Co., Texas	North America/USA/Texas/Pasadena
North America/USA/Penrose Co/	North America/USA/Colorado/Penrose Co
North America/USA/Phoenix/Maricopa Co., Az	North America/USA/Arizona/Phoenix
North America/USA/Plano/Collin Co., Texas	North America/USA/Texas/Plano
North America/USA/Putnam Co./Ny	North America/USA/New York/Putnam Co.
North America/USA/Queens Co./Ny	North America/USA/New York/Queens Co.
North America/USA/Rapid City Sd/	North America/USA/South Dakota/Rapid City Sd
North America/USA/Rapid City/Sd	North America/USA/South Dakota/Rapid City
North America/USA/Rensselaer Co./Ny	North America/USA/New York/Rensselaer Co.
North America/USA/Richmond Co./Ny	North America/USA/New York/Richmond Co.
North America/USA/Rochester Mn/	North America/USA/Minnesota/Rochester Mn
North America/USA/Rockland Co./Ny	North America/USA/New York/Rockland Co.
North America/USA/San Antonio Tx/	North America/USA/Texas/San Antonio Tx
North America/USA/San Diego Ca/	North America/USA/California/San Diego Ca
North America/USA/San Francisco Ca/	North America/USA/California/San Francisco Ca
North America/USA/Sanborn Mn/	North America/USA/Minnesota/Sanborn Mn
North America/USA/Saratoga Co./Ny	North America/USA/New York/Saratoga Co.
North America/USA/Schenectady Co./Ny	North America/USA/New York/Schenectady Co.
North America/USA/Schoharie Co./Ny	North America/USA/New York/Schoharie Co.
North America/USA/Schuyler Co./Ny	North America/USA/New York/Schuyler Co.
North America/USA/Seneca Co./Ny	North America/USA/New York/Seneca Co.
North America/USA/Shreveport la/	North America/USA/Louisiana/Shreveport la
North America/USA/Sioux City Ia/	North America/USA/Iowa/Sioux City Ia
North America/USA/Sioux Falls Sd/	North America/USA/South Dakota/Sioux Falls Sd
North America/USA/South Bend In/	North America/USA/Indiana/South Bend In
North America/USA/St. Joseph County/In	North America/USA/Indiana/St. Joseph County
North America/USA/St. Lawrence Co./Ny	North America/USA/New York/St. Lawrence Co.
North America/USA/Steuben Co./Ny	North America/USA/New York/Steuben Co.
North America/USA/Suffolk Co./Ny	North America/USA/New York/Suffolk Co.
North America/USA/Suffolk Couunty/Ny	North America/USA/New York/Suffolk Couunty
North America/USA/Sufolk Co./Ny	North America/USA/New York/Sufolk Co.
North America/USA/Tampa Fl/	North America/USA/Florida/Tampa Fl
North America/USA/Tarrant Co. Tx/	North America/USA/Texas/Tarrant Co. Tx
North America/USA/Tempe Az/	North America/USA/Arizona/Tempe Az
North America/USA/Tompkins Co./Ny	North America/USA/New York/Tompkins Co.
North America/USA/Travis Co. Tx/	North America/USA/Texas/Travis Co. Tx
North America/USA/Tyler Tx/	North America/USA/Texas/Tyler Tx
North America/USA/Ulster Co./Ny	North America/USA/New York/Ulster Co.
North America/USA/Warren Co./Ny	North America/USA/New York/Warren Co.
North America/USA/Washington Co./Ny	North America/USA/New York/Washington Co.
North America/USA/Weschester Co./Ny	North America/USA/New York/Weschester Co.
North America/USA/Westchester Co./Ny	North America/USA/New York/Westchester Co.
North America/USA/Williamson Co. Tx/	North America/USA/Texas/Williamson Co. Tx
North America/USA/Wyoming Co./Ny	North America/USA/New York/Wyoming Co.
North America/USA/Agoura_Hills/California	North America/USA/California/Agoura_Hills
North America/USA/Allen/Louisiana	North America/USA/Louisiana/Allen
North America/USA/Alpine/California	North America/USA/California/Alpine
North America/USA/Alta_Loma/California	North America/USA/California/Alta_Loma
North America/USA/Anderson/California	North America/USA/California/Anderson
North America/USA/Anoka/Minnesota	North America/USA/Minnesota/Anoka
North America/USA/Antioch/California	North America/USA/California/Antioch
North America/USA/Apache Co./Arizona	North America/USA/Arizona/Apache Co.
North America/USA/Armona/California	North America/USA/California/Armona
North America/USA/Arvin/California	North America/USA/California/Arvin
North America/USA/Ascension/Louisiana	North America/USA/Louisiana/Ascension
North America/USA/Atwater/California	North America/USA/California/Atwater
North America/USA/Bakersfield/California	North America/USA/California/Bakersfield
North America/USA/Bellflower/California	North America/USA/California/Bellflower
North America/USA/Belmont/Ohio	North America/USA/Ohio/Belmont
North America/USA/Beltrami/Minnesota	North America/USA/Minnesota/Beltrami
North America/USA/Benton/Minnesota	North America/USA/Minnesota/Benton
North America/USA/Benton/Oregon	North America/USA/Oregon/Benton
North America/USA/Beverly_Hills/California	North America/USA/California/Beverly_Hills
North America/USA/Big Stone/Minnesota	North America/USA/Minnesota/Big Stone
North America/USA/Black Hawk/Iowa	North America/USA/Iowa/Black Hawk
North America/USA/Bossier/Louisiana	North America/USA/Louisiana/Bossier
North America/USA/Bowerbank/California	North America/USA/California/Bowerbank
North America/USA/Brown/Minnesota	North America/USA/Minnesota/Brown
North America/USA/Butte/California	North America/USA/California/Butte
North America/USA/Butte_Valley/California	North America/USA/California/Butte_Valley
North America/USA/Buttonwillow/California	North America/USA/California/Buttonwillow
North America/USA/Caddo/Louisiana	North America/USA/Louisiana/Caddo
North America/USA/Calcasieu/Louisiana	North America/USA/Louisiana/Calcasieu
North America/USA/Cardiff/California	North America/USA/California/Cardiff
North America/USA/Carlsbad/California	North America/USA/California/Carlsbad
North America/USA/Carver/Minnesota	North America/USA/Minnesota/Carver
North America/USA/Cass/Minnesota	North America/USA/Minnesota/Cass
North America/USA/Ceres/California	North America/USA/California/Ceres
North America/USA/Cheshire/New Hampshire	North America/USA/New Hampshire/Cheshire
North America/USA/Chico/California	North America/USA/California/Chico
North America/USA/Chula_Vista/California	North America/USA/California/Chula_Vista
North America/USA/Clearlake/California	North America/USA/California/Clearlake
North America/USA/Clotho/California	North America/USA/California/Clotho
North America/USA/Cochise Co./Arizona	North America/USA/Arizona/Cochise Co.
North America/USA/Cook/Illinois	North America/USA/Illinois/Cook
North America/USA/Corona/California	North America/USA/California/Corona
North America/USA/Coronado/California	North America/USA/California/Coronado
North America/USA/Crow Wing/Minnesota	North America/USA/Minnesota/Crow Wing
North America/USA/Dakota/Minnesota	North America/USA/Minnesota/Dakota
North America/USA/Danville/California	North America/USA/California/Danville
North America/USA/Dekalb County/Georgia	North America/USA/Georgia/Dekalb County
North America/USA/Del_Mar/California	North America/USA/California/Del_Mar
North America/USA/Del_Ray/California	North America/USA/California/Del_Ray
North America/USA/Delano/California	North America/USA/California/Delano
North America/USA/Denair/California	North America/USA/California/Denair
North America/USA/Descanso/California	North America/USA/California/Descanso
North America/USA/Desmoines/Iowa	North America/USA/Iowa/Desmoines
North America/USA/Dickinson/Iowa	North America/USA/Iowa/Dickinson
North America/USA/Dos_Palos/California	North America/USA/California/Dos_Palos
North America/USA/Doyle/California	North America/USA/California/Doyle
North America/USA/Earlimart/California	North America/USA/California/Earlimart
North America/USA/Ebr/Louisiana	North America/USA/Louisiana/Ebr
North America/USA/El Paso/Texas	North America/USA/Texas/El Paso
North America/USA/El_Cajon/California	North America/USA/California/El_Cajon
North America/USA/Encinitas/California	North America/USA/California/Encinitas
North America/USA/Encino/California	North America/USA/California/Encino
North America/USA/Escondido/California	North America/USA/California/Escondido
North America/USA/Fallbrook/California	North America/USA/California/Fallbrook
North America/USA/Fillmore/Minnesota	North America/USA/Minnesota/Fillmore
North America/USA/Finley/California	North America/USA/California/Finley
North America/USA/Firebaugh/California	North America/USA/California/Firebaugh
North America/USA/Fontana/California	North America/USA/California/Fontana
North America/USA/Franklin/Ohio	North America/USA/Ohio/Franklin
North America/USA/Franklin/Washington	North America/USA/Washington/Franklin
North America/USA/Fremont/California	North America/USA/California/Fremont
North America/USA/Fremont/Iowa	North America/USA/Iowa/Fremont
North America/USA/Fresno/California	North America/USA/California/Fresno
North America/USA/Glenn/California	North America/USA/California/Glenn
North America/USA/Granada_Hills/California	North America/USA/California/Granada_Hills
North America/USA/Grant/Washington	North America/USA/Washington/Grant
North America/USA/Greenacres/California	North America/USA/California/Greenacres
North America/USA/Gridley/California	North America/USA/California/Gridley
North America/USA/Hall County/Texas	North America/USA/Texas/Hall County
North America/USA/Hamilton/Ohio	North America/USA/Ohio/Hamilton
North America/USA/Hanford/California	North America/USA/California/Hanford
North America/USA/Harmony/California	North America/USA/California/Harmony
North America/USA/Harris Co./Texas	North America/USA/Texas/Harris Co.
North America/USA/Hennepin/Minnesota	North America/USA/Minnesota/Hennepin
North America/USA/Hillsborough/New Hampshire	North America/USA/New Hampshire/Hillsborough
North America/USA/Hinds County/Mississippi	North America/USA/Mississippi/Hinds County
North America/USA/Imperial_Beach/California	North America/USA/California/Imperial_Beach
North America/USA/Jackson/Oregon	North America/USA/Oregon/Jackson
North America/USA/Josephine/Oregon	North America/USA/Oregon/Josephine
North America/USA/Kandiyohi/Minnesota	North America/USA/Minnesota/Kandiyohi
North America/USA/Kerman/California	North America/USA/California/Kerman
North America/USA/Kern/California	North America/USA/California/Kern
North America/USA/Kings/California	North America/USA/California/Kings
North America/USA/Kingsburg/California	North America/USA/California/Kingsburg
North America/USA/Kittitas/Washington	North America/USA/Washington/Kittitas
North America/USA/Klamath/Oregon	North America/USA/Oregon/Klamath
North America/USA/La_Jolla/California	North America/USA/California/La_Jolla
North America/USA/La_Mesa/California	North America/USA/California/La_Mesa
North America/USA/La_Verne/California	North America/USA/California/La_Verne
North America/USA/Lake/California	North America/USA/California/Lake
North America/USA/Lake_Balboa/California	North America/USA/California/Lake_Balboa
North America/USA/Lakeside/California	North America/USA/California/Lakeside
North America/USA/Lakeview/California	North America/USA/California/Lakeview
North America/USA/Lakewood/California	North America/USA/California/Lakewood
North America/USA/Lancaster/California	North America/USA/California/Lancaster
North America/USA/Larimer/Colorado	North America/USA/Colorado/Larimer
North America/USA/Laton/California	North America/USA/California/Laton
North America/USA/Lemon_Grove/California	North America/USA/California/Lemon_Grove
North America/USA/Lemoore/California	North America/USA/California/Lemoore
North America/USA/Lincoln/Washington	North America/USA/Washington/Lincoln
North America/USA/Livermore/California	North America/USA/California/Livermore
North America/USA/Long_Beach/California	North America/USA/California/Long_Beach
North America/USA/Loomis/California	North America/USA/California/Loomis
North America/USA/Lorain/Ohio	North America/USA/Ohio/Lorain
North America/USA/Los Angeles/California	North America/USA/California/Los Angeles
North America/USA/Lucas/Ohio	North America/USA/Ohio/Lucas
North America/USA/Lyon/Minnesota	North America/USA/Minnesota/Lyon
North America/USA/Madera/California	North America/USA/California/Madera
North America/USA/Mahnomen/Minnesota	North America/USA/Minnesota/Mahnomen
North America/USA/Malheur/Oregon	North America/USA/Oregon/Malheur
North America/USA/Maricopoa Co./Arizona	North America/USA/Arizona/Maricopoa Co.
North America/USA/Martinez/California	North America/USA/California/Martinez
North America/USA/Marysville/California	North America/USA/California/Marysville
North America/USA/Meeker/Minnesota	North America/USA/Minnesota/Meeker
North America/USA/Mello/California	North America/USA/California/Mello
North America/USA/Mira_Mesa/California	North America/USA/California/Mira_Mesa
North America/USA/Modesto/California	North America/USA/California/Modesto
North America/USA/Monona/Iowa	North America/USA/Iowa/Monona
North America/USA/Montebello/California	North America/USA/California/Montebello
North America/USA/Montgomery/Ohio	North America/USA/Ohio/Montgomery
North America/USA/Morrow/Oregon	North America/USA/Oregon/Morrow
North America/USA/Mower/Minnesota	North America/USA/Minnesota/Mower
North America/USA/Nan/Idaho	North America/USA/Idaho/
North America/USA/Nan/Iowa	North America/USA/Iowa/
North America/USA/Nan/Virgin Islands	North America/USA/Virgin Islands/
North America/USA/National_City/California	North America/USA/California/National_City
North America/USA/Nicollet/Minnesota	North America/USA/Minnesota/Nicollet
North America/USA/Nobles/Minnesota	North America/USA/Minnesota/Nobles
North America/USA/Norco/California	North America/USA/California/Norco
North America/USA/North_Lakeport/California	North America/USA/California/North_Lakeport
North America/USA/Northridge/California	North America/USA/California/Northridge
North America/USA/Notarb/California	North America/USA/California/Notarb
North America/USA/O'Brien/Iowa	North America/USA/Iowa/O'Brien
North America/USA/Oakley/California	North America/USA/California/Oakley
North America/USA/Oasis/California	North America/USA/California/Oasis
North America/USA/Oceanside/California	North America/USA/California/Oceanside
North America/USA/Olmsted/Minnesota	North America/USA/Minnesota/Olmsted
North America/USA/Ontario/California	North America/USA/California/Ontario
North America/USA/Oroville/California	North America/USA/California/Oroville
North America/USA/Otter Tail/Minnesota	North America/USA/Minnesota/Otter Tail
North America/USA/Ouachita/Louisiana	North America/USA/Louisiana/Ouachita
North America/USA/Paradise/California	North America/USA/California/Paradise
North America/USA/Parlier/California	North America/USA/California/Parlier
North America/USA/Pennington/Minnesota	North America/USA/Minnesota/Pennington
North America/USA/Pierce/Washington	North America/USA/Washington/Pierce
North America/USA/Pine_Valley/California	North America/USA/California/Pine_Valley
North America/USA/Pixley/California	North America/USA/California/Pixley
North America/USA/Pleasant_Grove/California	North America/USA/California/Pleasant_Grove
North America/USA/Polk/Iowa	North America/USA/Iowa/Polk
North America/USA/Pope/Minnesota	North America/USA/Minnesota/Pope
North America/USA/Pottawattamie/Iowa	North America/USA/Iowa/Pottawattamie
North America/USA/Poway/California	North America/USA/California/Poway
North America/USA/Ramona/California	North America/USA/California/Ramona
North America/USA/Ramsey/Minnesota	North America/USA/Minnesota/Ramsey
North America/USA/Redding/California	North America/USA/California/Redding
North America/USA/Redlands/California	North America/USA/California/Redlands
North America/USA/Redondo/California	North America/USA/California/Redondo
North America/USA/Redwood/Minnesota	North America/USA/Minnesota/Redwood
North America/USA/Renville/Minnesota	North America/USA/Minnesota/Renville
North America/USA/Riverdale/California	North America/USA/California/Riverdale
North America/USA/Riverside/California	North America/USA/California/Riverside
North America/USA/Rockingham/New Hampshire	North America/USA/New Hampshire/Rockingham
North America/USA/Roseville/California	North America/USA/California/Roseville
North America/USA/Rowland/California	North America/USA/California/Rowland
North America/USA/Sacramento/California	North America/USA/California/Sacramento
North America/USA/San Bernardino/California	North America/USA/California/San Bernardino
North America/USA/San Diego/California	North America/USA/California/San Diego
North America/USA/San_Andreas/California	North America/USA/California/San_Andreas
North America/USA/San_Diego/California	North America/USA/California/San_Diego
North America/USA/San_Fernando/California	North America/USA/California/San_Fernando
North America/USA/San_Marcos/California	North America/USA/California/San_Marcos
North America/USA/Sanger/California	North America/USA/California/Sanger
North America/USA/Santa_Ysabel/California	North America/USA/California/Santa_Ysabel
North America/USA/Santee/California	North America/USA/California/Santee
North America/USA/Scott/Minnesota	North America/USA/Minnesota/Scott
North America/USA/Shafter/California	North America/USA/California/Shafter
North America/USA/Sherburne/Minnesota	North America/USA/Minnesota/Sherburne
North America/USA/Sierra_Madre/California	North America/USA/California/Sierra_Madre
North America/USA/Simi_Valley/California	North America/USA/California/Simi_Valley
North America/USA/Solana_Beach/California	North America/USA/California/Solana_Beach
North America/USA/Solano/California	North America/USA/California/Solano
North America/USA/South_Gate/California	North America/USA/California/South_Gate
North America/USA/South_Whittier/California	North America/USA/California/South_Whittier
North America/USA/Spokane/Washington	North America/USA/Washington/Spokane
North America/USA/St. Louis/Minnesota	North America/USA/Minnesota/St. Louis
North America/USA/St. Tammany/Louisiana	North America/USA/Louisiana/St. Tammany
North America/USA/St. Tammany Parish/Louisiana	North America/USA/Louisiana/St. Tammany Parish
North America/USA/Stanislaus/California	North America/USA/California/Stanislaus
North America/USA/Stearns/Minnesota	North America/USA/Minnesota/Stearns
North America/USA/Steele/Minnesota	North America/USA/Minnesota/Steele
North America/USA/Stevens/Minnesota	North America/USA/Minnesota/Stevens
North America/USA/Stockton/California	North America/USA/California/Stockton
North America/USA/Story/Iowa	North America/USA/Iowa/Story
North America/USA/Strafford/New Hampshire	North America/USA/New Hampshire/Strafford
North America/USA/Sultana/California	North America/USA/California/Sultana
North America/USA/Summit/Ohio	North America/USA/Ohio/Summit
North America/USA/Tangipahoa/Louisiana	North America/USA/Louisiana/Tangipahoa
North America/USA/Temple_City/California	North America/USA/California/Temple_City
North America/USA/Thousand_Oaks/California	North America/USA/California/Thousand_Oaks
North America/USA/Tulare/California	North America/USA/California/Tulare
North America/USA/Turlock/California	North America/USA/California/Turlock
North America/USA/Umatilla/Oregon	North America/USA/Oregon/Umatilla
North America/USA/Valley_Center/California	North America/USA/California/Valley_Center
North America/USA/Van Buren/Iowa	North America/USA/Iowa/Van Buren
North America/USA/Van_Nuys/California	North America/USA/California/Van_Nuys
North America/USA/Visalia/California	North America/USA/California/Visalia
North America/USA/Walla/Washington	North America/USA/Washington/Walla
North America/USA/Walnut_Creek/California	North America/USA/California/Walnut_Creek
North America/USA/Wasco/California	North America/USA/California/Wasco
North America/USA/Waseca/Minnesota	North America/USA/Minnesota/Waseca
North America/USA/Washington/Minnesota	North America/USA/Minnesota/Washington
North America/USA/Wbr/Louisiana	North America/USA/Louisiana/Wbr
North America/USA/West_Covina/California	North America/USA/California/West_Covina
North America/USA/West_Hills/California	North America/USA/California/West_Hills
North America/USA/Williams/Ohio	North America/USA/Ohio/Williams
North America/USA/Winnetka/California	North America/USA/California/Winnetka
North America/USA/Woodbury/Iowa	North America/USA/Iowa/Woodbury
North America/USA/Woodville/California	North America/USA/California/Woodville
North America/USA/Yolo/California	North America/USA/California/Yolo
North America/USA/Yuba_City/California	North America/USA/California/Yuba_City
